0 0 0 0 0 0 0 0 0 0
0 1 2 1 3 2 3 6 6 0
0 2 2 3 3 4 1 2 3 0
0 4 5 5 4 2 3 4 2 0
0 2 3 5 5 4 4 3 4 0
0 2 3 2 3 5 5 1 5 0
0 5 1 3 2 4 2 4 2 0
0 6 2 5 6 5 2 3 3 0
0 0 0 0 0 0 0 0 0 0
