0 0 0 0 0 0 0 0 0 0 0 0 0 0 0 0 0 0
0 1 2 3 4 5 3 6 7 2 8 5 8 9 10 11 12 0
0 13 14 15 16 17 18 11 2 19 20 21 13 9 18 16 7 0
0 17 22 23 24 15 22 25 13 11 26 19 27 34 28 19 3 0
0 24 33 33 35 20 4 25 1 16 13 36 31 4 28 30 29 0
0 14 16 33 20 15 36 31 32 25 14 34 17 22 1 4 12 0
0 5 27 31 2 24 21 30 28 34 21 30 31 26 33 11 8 0
0 15 7 1 36 10 34 18 3 23 29 29 26 29 22 12 17 0
0 8 35 10 24 6 12 25 35 26 32 27 23 23 18 36 14 0
0 30 20 32 9 4 32 21 9 5 28 27 6 35 6 19 10 0
0 0 0 0 0 0 0 0 0 0 0 0 0 0 0 0 0 0
