0 0 0 0 0 0 0 0 0 0 0 0 0 0 0 0 0 0 
0 1 2 3 7 27 31 20 7 2 33 5 8 9 10 17 12 0 
0 13 14 15 16 30 18 11 2 32 20 30 36 9 18 16 33 0 
0 25 22 24 6 15 22 25 13 11 4 19 27 5 28 36 3 0 
0 29 32 33 35 26 4 17 1 16 13 13 3 4 31 20 23 0 
0 14 25 33 7 15 19 14 32 25 14 34 17 22 36 4 12 0 
0 16 34 31 28 24 21 30 2 34 36 30 31 27 15 11 27 0 
0 8 7 1 18 10 34 21 3 23 21 28 26 29 22 12 17 0 
0 8 10 10 24 24 12 5 35 26 21 6 23 23 18 1 11 0 
0 29 20 32 9 26 19 29 9 5 28 8 6 35 6 19 35 0 
0 0 0 0 0 0 0 0 0 0 0 0 0 0 0 0 0 0 
