0 0 0 0 0 0 0 0 0 0 0 0 0 0 0 0 0 0 
0 1 2 3 7 5 31 36 22 2 33 5 8 9 10 20 12 0 
0 17 14 24 16 29 18 11 2 32 17 20 27 21 18 16 32 0 
0 3 22 23 6 15 7 25 13 11 4 19 27 27 28 24 20 0 
0 6 33 20 35 13 4 25 1 26 13 36 13 4 31 15 29 0 
0 14 5 33 7 15 19 28 32 25 14 26 17 22 1 4 12 0 
0 16 27 31 2 24 21 35 28 34 6 30 31 26 30 11 8 0 
0 8 7 17 36 10 34 18 3 23 12 10 26 29 22 21 1 0 
0 8 35 10 15 24 12 25 35 34 9 33 23 23 18 36 11 0 
0 30 3 32 9 16 19 29 9 5 28 34 21 30 6 19 14 0 
0 0 0 0 0 0 0 0 0 0 0 0 0 0 0 0 0 0 
