0 0 0 0 0 0 0 0 0 0 0 0 0 0 0 0 0 0 
0 1 2 3 7 2 31 6 7 2 25 5 8 9 10 4 12 0 
0 13 14 15 1 29 18 31 2 32 20 20 35 9 19 16 33 0 
0 17 14 23 6 15 22 25 13 11 4 26 27 27 28 36 3 0 
0 24 32 33 35 27 4 25 16 16 13 36 3 4 31 30 29 0 
0 14 5 33 18 15 19 28 32 33 34 11 17 22 1 17 30 0 
0 16 27 22 30 24 21 13 28 34 21 5 31 17 15 11 8 0 
0 8 8 1 36 10 34 18 3 23 21 14 26 12 22 12 26 0 
0 10 35 7 24 24 12 25 35 19 21 20 23 23 7 36 32 0 
0 30 20 11 9 26 19 29 9 5 28 34 6 29 6 18 10 0 
0 0 0 0 0 0 0 0 0 0 0 0 0 0 0 0 0 0 
