0 0 0 0 0 0 0 0 0 0 0 0 0 0 0 0 0 0 
0 29 2 3 7 5 31 6 21 2 33 5 8 9 22 17 20 0 
0 13 14 15 16 29 34 11 2 32 3 20 13 9 18 16 33 0 
0 17 30 23 6 15 24 25 13 11 8 19 27 15 28 18 20 0 
0 24 32 33 35 27 4 25 6 16 13 36 7 36 31 22 29 0 
0 14 5 33 26 15 19 28 32 25 14 34 17 6 1 27 12 0 
0 16 27 31 2 22 21 30 28 36 21 30 31 26 4 11 11 0 
0 8 7 24 4 10 34 18 3 23 21 14 26 29 10 12 17 0 
0 8 35 10 24 1 12 25 35 5 7 12 23 23 18 36 4 0 
0 30 20 32 9 3 19 1 9 26 28 34 1 35 22 19 10 0 
0 0 0 0 0 0 0 0 0 0 0 0 0 0 0 0 0 0 
