0 0 0 0 0 0 0 0 0 0 0 0 0 0 0 0 0 0 
0 1 2 3 7 5 31 6 7 2 35 26 8 30 10 17 12 0 
0 13 14 15 16 29 18 27 2 12 20 20 16 9 18 12 33 0 
0 17 22 23 6 15 22 25 13 11 4 19 11 27 28 36 3 0 
0 24 32 33 35 27 4 25 1 13 5 36 3 4 31 9 29 0 
0 14 30 33 7 15 19 28 13 25 14 34 17 27 1 4 32 0 
0 16 22 10 2 24 21 30 15 34 32 30 31 26 31 11 8 0 
0 8 7 1 28 10 33 18 3 23 21 21 26 29 22 12 17 0 
0 32 35 36 24 24 16 25 34 5 14 20 23 6 18 36 11 0 
0 5 20 8 9 26 19 29 9 21 28 34 23 35 6 19 10 0 
0 0 0 0 0 0 0 0 0 0 0 0 0 0 0 0 0 0 
