0 0 0 0 0 0 0 0 0 0 0 0 0 0 0 0 0 0 
0 1 2 3 7 5 31 6 7 2 33 5 8 9 10 17 12 0 
0 13 14 15 16 29 18 11 2 32 20 20 13 9 18 16 33 0 
0 17 22 23 6 15 22 25 13 11 4 19 27 27 28 36 3 0 
0 24 32 33 35 27 4 25 1 16 13 36 3 4 31 30 29 0 
0 14 5 33 7 15 19 28 32 25 14 34 17 22 1 4 12 0 
0 16 27 31 2 24 21 30 28 34 21 30 31 26 15 11 8 0 
0 8 7 1 36 10 34 18 3 23 21 14 26 29 22 12 17 0 
0 8 35 10 24 24 12 25 35 26 21 20 23 23 18 36 11 0 
0 30 20 32 9 26 19 29 9 5 28 34 6 35 6 19 10 0 
0 0 0 0 0 0 0 0 0 0 0 0 0 0 0 0 0 0 
