0 0 0 0 0 0 0 0 0 0 0 0 0 0 0 0 0 0 
0 1 26 3 35 5 31 6 7 2 33 5 8 9 10 17 19 0 
0 13 14 15 16 29 18 11 2 32 20 20 13 7 18 16 33 0 
0 17 22 23 6 15 22 25 13 11 34 12 27 27 29 36 3 0 
0 24 32 33 9 27 4 8 1 16 13 36 3 4 31 30 26 0 
0 14 24 22 7 15 19 32 28 25 14 34 17 33 1 4 28 0 
0 24 27 31 2 12 21 30 12 34 21 5 31 14 15 11 25 0 
0 8 7 26 36 10 34 18 3 23 21 29 1 28 22 12 17 0 
0 8 35 10 24 20 30 28 35 26 21 16 23 23 18 36 11 0 
0 30 20 32 9 2 19 29 9 5 25 4 6 35 6 19 10 0 
0 0 0 0 0 0 0 0 0 0 0 0 0 0 0 0 0 0 
