0 0 0 0 0 0 0 0 0 0 0 0 0 0 0 0 0 0 
0 10 2 3 7 5 31 6 7 2 33 5 8 9 10 27 12 0 
0 13 14 15 32 29 18 11 12 34 20 20 13 9 5 16 33 0 
0 17 22 23 6 15 10 25 13 29 18 19 17 27 28 31 3 0 
0 24 32 33 35 27 4 25 1 16 13 36 27 4 31 11 29 0 
0 14 5 33 7 15 19 14 32 7 14 34 17 22 1 4 30 0 
0 16 3 1 2 24 21 30 28 34 21 8 36 26 15 11 12 0 
0 8 25 1 36 3 34 4 31 23 21 28 26 11 22 2 17 0 
0 8 35 22 24 24 12 25 35 26 21 20 23 23 18 10 30 0 
0 30 20 32 9 26 19 29 9 18 28 16 6 35 6 19 36 0 
0 0 0 0 0 0 0 0 0 0 0 0 0 0 0 0 0 0 
