0 0 0 0 0 0 0 0 0 0 0 0 0 0 0 0 0 0 
0 1 2 3 7 5 31 6 7 2 33 5 8 36 11 17 12 0 
0 13 14 15 16 21 18 11 2 4 20 20 13 9 18 3 30 0 
0 17 22 23 6 15 22 25 13 11 4 19 27 27 19 13 16 0 
0 24 32 17 35 27 4 25 1 16 36 9 3 4 34 33 29 0 
0 14 22 33 17 15 19 28 32 20 14 34 33 22 1 26 12 0 
0 16 27 31 2 12 21 30 28 34 19 30 31 26 15 10 8 0 
0 8 23 1 36 10 34 32 3 23 21 14 26 29 5 24 7 0 
0 8 6 10 24 24 12 25 35 32 21 20 7 23 18 36 11 0 
0 30 25 18 9 26 28 29 9 5 28 31 6 35 35 29 10 0 
0 0 0 0 0 0 0 0 0 0 0 0 0 0 0 0 0 0 
