0 0 0 0 0 0 0 0 0 0 0 0 0 0 0 0 0 0 
0 35 21 3 25 5 31 4 27 2 33 5 8 9 10 32 12 0 
0 25 14 15 16 29 18 11 2 17 20 25 22 9 18 8 33 0 
0 32 22 23 6 15 22 25 13 11 4 19 31 27 28 10 3 0 
0 27 32 29 1 24 4 20 1 16 13 36 3 4 31 30 29 0 
0 14 5 33 7 15 19 28 17 35 14 34 17 22 1 6 12 0 
0 16 27 31 2 24 21 30 28 34 21 10 7 26 15 23 8 0 
0 16 7 1 36 36 28 18 3 11 2 14 26 29 13 12 34 0 
0 8 13 30 24 24 12 7 35 26 21 20 23 23 18 36 11 0 
0 30 20 32 9 26 19 33 9 5 34 17 6 35 6 19 10 0 
0 0 0 0 0 0 0 0 0 0 0 0 0 0 0 0 0 0 
